................................
................................
................................
.....3333................4......
.12.............................
....3666335533.............77777
33333333333................33333