333333333333333333333333
3......................3
3......................3
3......................3
3......B....R..........3
3......................3
3......................3
3....3333333333333333333
3......................3
344...B.....R..........3
3......................3
3...........7..........3
333333333333333........3
3.............3333.....3
3.....B....R..........33
3....................333
312.................3333
333336663355533333333333
....3333333333..........