333333333333...333333333
3......................3
3......................3
3.............33.......3
3......................3
.......................3
..........33...........3
3......................3
3.....33................
3......................3
3......................3
3...333.........4......3
312....................3
3...3666335533......7773
33333333333.........3333
3.......................
3.......................
3.3333333333333333333333